#domain
hospital
#levelname
MAPF02B
#colors
blue: 0,A,B,C
#initial
++++++++++
+0    A  +
+      +++
+        +
+   B ++ +
+      + +
++++++++++
#goal
++++++++++
+        +
+     ++++
+        +
+     ++ +
+      +0+
++++++++++
#end
